6 6 6 6 6 6 6 6 6 6 6 6 6 6 6 6 6 6 6 6 6 6 6 6 6 6 6 6 6 6 6 6 6 6 6 6 6 6 6 6 6 6 6 6 6 6 6 6 6 6
6 6 6 6 6 6 6 6 6 6 6 6 6 6 6 6 6 6 6 6 6 6 6 6 6 6 6 6 6 6 6 6 6 6 6 6 6 6 6 6 6 6 6 6 6 6 6 6 6 6
6 6 4 4 4 4 4 4 4 4 4 4 4 4 4 4 4 4 4 4 2 2 2 2 2 2 2 4 4 4 4 4 4 4 4 4 4 4 4 4 4 4 4 4 4 4 4 4 6 6 
6 6 4 4 4 4 4 4 4 4 4 4 4 4 4 4 4 4 4 4 2 2 2 2 2 2 2 4 4 4 4 4 4 4 4 4 4 4 4 4 4 4 4 4 4 4 4 4 6 6 
6 6 4 4 4 4 4 4 1 1 1 1 1 4 4 4 4 4 4 4 2 2 2 2 2 2 2 4 4 4 4 4 4 4 4 4 4 4 4 4 4 4 4 4 4 4 4 4 6 6 
6 6 4 4 4 4 4 4 1 1 1 1 1 4 4 4 4 4 4 4 4 2 2 2 2 2 4 4 4 4 4 4 4 1 1 1 1 1 1 1 1 1 1 4 4 4 4 4 6 6 
6 6 4 4 4 4 4 4 1 3 3 3 1 4 4 4 4 4 4 4 5 5 5 5 5 5 5 4 4 4 4 4 4 1 3 3 3 3 3 3 3 3 1 4 4 4 4 4 6 6 
6 6 4 4 4 4 4 4 1 3 3 3 1 4 4 4 4 4 4 4 4 5 5 5 5 5 4 4 4 4 4 4 4 1 3 3 3 3 3 3 3 3 1 4 4 4 4 4 6 6 
6 6 4 4 4 4 4 4 1 3 3 3 1 4 4 4 4 4 4 4 4 4 5 5 5 4 4 4 4 4 4 4 4 1 3 3 3 3 3 3 3 3 1 4 4 4 4 4 6 6 
6 6 4 4 4 4 4 4 1 3 3 3 1 4 4 4 4 4 4 4 4 4 4 5 4 4 4 4 4 4 4 4 4 1 3 3 3 3 3 3 3 3 1 4 4 4 4 4 6 6 
6 6 4 4 4 4 4 4 1 1 5 1 1 4 4 4 4 4 4 4 4 4 4 5 4 4 1 1 1 1 1 1 1 1 3 3 3 3 3 3 3 3 1 4 4 4 4 4 6 6 
6 6 4 4 4 4 4 4 4 4 5 4 4 4 4 4 1 1 1 1 1 4 4 5 4 4 1 3 3 3 3 3 1 1 3 3 3 3 3 3 3 3 1 4 4 4 4 4 6 6 
6 6 1 1 1 1 1 4 4 4 5 4 4 4 4 4 1 3 3 3 1 4 4 5 4 4 1 3 3 3 3 3 1 1 1 1 1 1 5 1 1 1 1 4 4 4 4 4 6 6 
6 6 1 3 3 3 1 4 4 4 5 4 4 4 4 4 1 3 3 3 5 5 5 5 5 5 5 3 3 3 3 3 1 4 4 4 4 4 5 4 4 4 4 4 4 4 4 4 6 6 
6 6 1 3 3 3 1 4 4 4 5 4 4 4 4 4 1 3 3 3 1 4 4 5 4 4 1 3 3 3 3 3 1 4 4 4 4 4 5 4 4 4 4 4 4 4 4 4 6 6 
6 6 1 3 3 3 1 4 5 5 5 4 4 4 4 4 1 1 1 1 1 4 4 5 4 4 1 3 3 3 3 3 1 4 4 4 4 4 5 4 4 4 4 4 4 4 4 4 6 6 
6 6 1 1 5 1 1 4 5 4 4 4 4 4 4 4 4 4 4 4 4 4 4 5 4 4 1 1 1 1 1 1 1 4 4 4 4 4 5 4 4 4 4 4 4 4 4 4 6 6 
6 6 4 4 5 4 4 4 5 4 4 4 4 4 4 4 4 4 4 4 4 4 0 5 0 4 4 4 4 4 4 4 4 4 4 4 5 5 5 4 4 4 4 4 4 4 4 4 6 6 
6 6 4 4 5 4 4 4 5 4 4 4 4 4 4 4 4 4 4 4 7 0 0 5 0 0 7 4 4 4 4 4 4 4 4 4 5 4 4 4 4 4 4 4 4 4 4 4 6 6 
6 6 4 4 5 4 4 4 5 4 4 4 4 4 4 4 4 4 4 4 0 0 0 5 0 0 0 4 4 4 4 4 4 4 4 5 5 4 4 4 1 1 1 1 1 4 4 4 6 6 
6 6 4 4 5 5 5 5 5 5 5 5 5 5 5 5 5 5 5 5 5 5 5 5 5 5 5 5 5 5 5 5 5 5 5 5 5 4 4 4 1 3 3 3 1 4 4 4 6 6 
6 6 4 4 5 4 4 4 5 4 4 4 5 4 4 4 4 4 4 4 0 0 0 5 0 0 0 4 4 4 4 4 4 4 4 5 5 4 4 4 1 3 3 3 1 4 4 4 6 6 
6 6 4 4 5 4 4 4 5 4 4 4 5 4 4 4 4 4 4 4 7 0 0 5 0 0 7 4 4 4 4 4 4 4 4 4 5 4 4 4 1 3 3 3 1 4 4 4 6 6 
6 6 4 4 5 4 4 4 5 4 4 4 5 4 4 4 4 4 4 4 4 4 0 5 0 4 4 4 4 4 4 4 4 4 4 4 5 4 4 4 1 1 8 1 1 4 4 4 6 6 
6 6 4 4 8 4 4 4 8 4 4 4 5 5 5 4 4 4 4 4 4 4 4 5 4 4 4 4 4 4 4 4 4 4 4 4 5 4 4 4 4 4 8 7 7 7 7 7 6 6 
6 6 4 4 8 4 4 4 8 4 4 4 4 4 8 4 4 4 4 4 4 4 4 8 4 4 4 4 4 4 2 2 2 4 4 4 5 4 4 4 4 4 8 7 7 7 7 7 6 6 
6 6 4 4 8 4 4 4 8 4 4 4 4 4 8 4 4 4 4 4 4 4 4 8 4 4 4 4 4 4 2 2 2 4 4 4 8 8 8 8 8 8 8 7 7 7 7 7 6 6 
6 6 4 4 8 4 4 4 8 4 4 4 4 4 8 4 4 2 0 0 4 4 4 8 4 4 4 4 4 4 0 0 0 4 4 4 8 7 7 7 7 7 7 7 7 7 7 7 6 6 
6 6 4 4 8 4 4 4 8 8 8 8 8 8 8 4 4 2 0 0 8 8 8 8 8 8 8 8 8 8 0 0 0 4 4 4 8 7 7 7 7 7 7 7 7 7 7 7 6 6 
6 6 4 4 8 4 4 4 8 8 8 8 8 8 8 4 4 2 0 0 4 4 4 8 4 4 4 4 4 4 0 0 0 4 4 4 8 7 7 7 7 7 7 7 7 7 7 7 6 6 
6 6 4 4 8 4 4 4 8 8 8 8 8 8 8 4 4 2 0 0 4 4 4 8 4 4 4 4 4 4 0 0 0 4 4 8 8 8 7 7 7 7 7 7 7 7 7 7 6 6 
6 6 4 4 8 4 4 4 8 8 8 8 8 8 8 4 4 4 4 4 4 4 4 8 4 4 4 4 2 2 2 0 0 4 4 8 8 8 7 7 7 7 7 7 7 7 7 7 6 6 
6 6 4 4 8 4 4 4 8 8 8 8 8 8 8 4 4 4 4 4 4 4 4 8 4 4 4 4 2 2 2 4 4 4 4 8 8 8 7 7 7 7 7 7 7 7 7 7 6 6 
6 6 4 4 8 4 4 4 8 8 8 8 8 8 8 4 4 4 4 4 4 4 4 8 4 4 4 4 4 4 4 4 4 4 4 8 8 8 7 7 7 7 7 7 7 7 7 7 6 6 
6 6 4 4 8 4 4 4 4 4 4 8 4 4 4 4 4 4 4 4 4 4 4 8 4 4 4 4 4 4 4 4 4 4 4 8 8 8 7 7 7 7 7 7 7 7 7 7 6 6 
6 6 4 4 8 4 4 4 4 4 4 8 4 4 4 4 4 4 4 8 8 8 8 8 8 8 8 4 4 4 4 4 4 4 8 8 8 8 8 7 7 7 7 7 7 7 7 7 6 6 
6 6 7 1 8 1 1 1 4 4 4 8 4 4 4 4 4 4 8 8 7 8 8 8 8 8 8 8 4 4 4 4 4 8 8 8 8 8 8 7 7 7 7 7 7 7 7 7 6 6 
6 6 7 1 3 3 3 1 4 4 8 8 8 4 4 4 4 4 8 8 8 8 8 8 8 7 8 8 4 4 4 4 8 8 8 8 8 8 8 7 7 7 7 7 7 7 7 7 6 6 
6 6 7 1 3 3 3 1 4 4 8 8 8 8 8 8 8 8 8 8 8 8 8 8 8 8 8 8 8 4 4 4 8 8 8 8 8 7 8 7 7 7 7 7 7 7 7 7 6 6 
6 6 7 1 3 3 3 1 4 8 8 7 8 8 7 7 7 7 8 8 8 8 8 8 8 8 8 8 8 8 8 8 8 8 7 8 8 8 8 7 7 7 7 7 7 7 7 7 6 6 
6 6 7 1 3 3 3 1 4 8 8 8 8 8 7 7 7 7 7 8 8 7 8 8 8 8 7 7 7 7 7 8 8 8 8 8 8 8 8 7 7 7 7 7 7 7 7 7 6 6 
6 6 7 1 1 1 1 1 4 8 8 8 8 7 7 7 7 7 7 7 8 8 8 8 8 8 7 7 7 7 7 8 8 7 8 8 7 8 8 7 7 7 7 7 7 7 7 7 6 6 
6 6 7 7 7 7 7 7 7 7 7 7 7 7 7 7 7 7 7 7 7 7 7 7 7 7 7 7 7 7 7 7 8 8 8 8 8 8 7 7 7 7 7 7 7 7 7 7 6 6 
6 6 7 7 7 7 7 7 7 7 7 7 7 7 7 7 7 7 7 7 7 7 7 7 7 7 7 7 7 7 7 7 7 7 7 7 7 7 7 7 7 7 7 7 7 7 7 7 6 6 
6 6 7 7 7 7 7 7 7 7 7 7 7 7 7 7 7 7 7 7 7 7 7 7 7 7 7 7 7 7 7 7 7 7 7 7 7 7 7 7 7 7 7 7 7 7 7 7 6 6 
6 6 7 7 7 7 7 7 7 7 7 7 7 7 7 7 7 7 7 7 7 7 7 7 7 7 7 7 7 7 7 7 7 7 7 7 7 7 7 7 7 7 7 7 7 7 7 7 6 6
6 6 6 6 6 6 6 6 6 6 6 6 6 6 6 6 6 6 6 6 6 6 6 6 6 6 6 6 6 6 6 6 6 6 6 6 6 6 6 6 6 6 6 6 6 6 6 6 6 6
6 6 6 6 6 6 6 6 6 6 6 6 6 6 6 6 6 6 6 6 6 6 6 6 6 6 6 6 6 6 6 6 6 6 6 6 6 6 6 6 6 6 6 6 6 6 6 6 6 6
6 6 6 6 6 6 6 6 6 6 6 6 6 6 6 6 6 6 6 6 6 6 6 6 6 6 6 6 6 6 6 6 6 6 6 6 6 6 6 6 6 6 6 6 6 6 6 6 6 6